3 4 4 4 4 9 4 4 4 4 10 4 4 4 4 5
3 4 4 4 9 4 10 4 9 4 4 10 4 4 4 5
3 4 4 10 4 4 4 9 4 4 4 10 4 9 4 5
3 9 4 9 4 10 4 4 10 4 4 9 4 4 4 5
3 4 4 10 4 4 4 4 10 4 10 4 9 4 9 5
3 4 4 10 4 9 4 9 4 4 9 4 4 4 10 5
3 4 10 4 9 4 9 4 10 4 9 4 9 4 4 5
3 4 4 9 4 4 4 4 4 10 4 4 4 4 10 5
3 4 4 4 10 4 4 4 10 9 4 4 9 4 9 5
3 10 4 9 4 4 9 4 10 4 9 4 4 10 4 5
3 4 9 4 9 4 10 4 4 4 4 4 10 4 10 5
3 4 10 4 4 9 4 10 4 4 4 4 9 4 4 5
